11111111111111111111
10000000000000000001
11101111010001110011
10100001000111000111
10001000000100000101
11101001110001100101
10001000000000101101
10011000100100000001
10110001000010000001
10000000000000100111
10000000000000100001
11111001000010100001
10001000100100001111
10101000000000001001
10100011100111011001
10100001110000000011
10111000000100000001
10000100001000011001
10000000110000001001
11111111111111111111
